1111111111111111111111111111
1P000X0X00000000000000X00001
1111011110111101111011111101
1C000C000C000C000C000000C001
1C000C000C000C000C000000C001
1C000CX00C000C000C000000C0E1
1111011110111101111011111101
100000000000X00000000X000001
1111011110111101111011111101
1000000000000000000000000001
1C000C000C0X0C000C000X00C001
1000000000000000000000000001
111101111011X101111011111101
1C000C000C000C000C000000C001
1111111111111111111111111111
